3 3 3 3 3 3 3 3 3 3 3 3 3 3 3 3 3 3 3 3 3 3 3 3 3 3 3 3 3 3 3 3 3 3 3 3 3 3 3 3 3 3 3 3 3 3 3 3 3 3
3 3 3 3 3 3 3 3 3 3 3 3 3 3 3 3 3 0 0 0 0 0 0 0 3 0 0 0 0 0 0 3 0 0 0 0 0 0 0 0 0 0 0 0 0 3 3 3 3 3
3 3 3 3 3 3 3 3 3 0 0 0 0 0 0 0 0 0 0 0 0 0 0 0 0 0 0 0 3 0 0 0 0 0 0 0 0 0 3 0 0 0 3 0 0 3 3 3 3 3
3 3 3 3 3 0 3 0 0 3 0 0 0 3 0 0 0 0 0 0 0 0 2 2 2 2 2 2 2 2 2 2 2 2 2 2 2 2 2 2 2 2 0 0 0 0 3 3 3 3
3 3 3 3 0 0 0 3 0 0 0 0 0 0 3 0 0 0 0 0 0 0 2 6 6 6 6 6 6 6 2 6 6 6 6 6 6 6 6 6 6 2 0 0 0 0 3 3 3 3
3 3 3 0 0 0 3 0 0 0 0 0 2 2 2 2 2 2 2 2 2 2 2 6 6 6 6 6 6 6 6 6 6 6 6 6 6 6 6 6 6 6 5 5 0 3 0 0 3 3
3 3 3 0 0 0 0 3 0 0 0 0 2 6 6 6 6 6 6 6 6 6 2 6 6 6 6 6 6 6 2 6 6 6 6 6 6 6 6 6 6 2 0 5 0 0 0 0 3 3
3 3 3 0 0 3 0 0 0 0 0 0 2 6 6 6 6 6 6 6 6 6 2 6 6 6 6 6 6 6 2 2 2 2 2 2 2 2 2 2 2 2 0 5 5 0 3 0 0 3
3 3 3 0 0 0 3 0 0 6 6 6 2 6 6 6 6 6 6 6 6 6 2 6 6 6 6 6 6 6 2 0 0 0 0 0 0 0 0 0 0 0 0 0 5 0 0 0 0 3
3 3 3 3 0 0 0 3 0 6 6 6 2 6 6 6 6 6 6 6 6 6 2 6 6 6 6 6 6 6 2 0 0 3 0 3 0 0 0 0 0 0 0 0 5 0 0 0 0 3
3 3 3 3 0 0 0 0 0 6 6 6 6 6 6 6 6 6 6 6 6 6 6 6 6 6 6 6 6 6 2 0 3 0 0 0 0 3 0 3 0 0 0 0 5 5 0 0 0 3
3 3 3 3 0 0 0 0 0 6 6 6 2 6 6 6 6 6 6 6 6 6 6 6 6 6 6 6 6 6 2 0 0 3 3 0 0 3 0 0 0 0 0 0 0 5 0 0 0 3
3 3 3 3 0 3 0 0 0 6 6 6 2 6 6 6 6 6 6 6 6 6 6 6 6 6 6 6 6 6 2 0 0 0 0 0 3 0 3 3 0 0 0 0 0 5 0 0 0 3
3 3 3 3 0 0 0 3 0 6 6 6 2 6 6 6 6 6 6 6 6 6 2 2 6 2 2 6 2 2 2 0 0 3 3 3 0 3 3 0 0 0 3 0 0 5 0 0 3 3
3 3 3 3 3 0 0 0 0 0 0 0 2 6 6 6 6 6 6 6 6 6 2 6 6 2 6 6 2 0 0 3 0 0 3 0 0 0 0 0 0 0 0 0 5 5 0 0 3 3
3 3 3 3 3 0 0 0 0 0 0 0 2 6 6 6 6 6 6 6 6 6 2 6 6 2 6 6 2 0 0 0 3 0 0 0 3 0 0 0 0 0 5 5 5 0 0 3 3 3
3 3 3 3 3 0 0 0 0 0 0 0 2 2 2 2 2 2 2 2 2 2 2 2 2 2 2 2 2 0 0 0 0 0 0 0 0 0 0 5 5 5 5 0 0 0 0 3 3 3
3 3 3 3 3 0 0 0 0 0 0 0 0 0 0 0 0 0 0 0 0 0 0 0 0 0 0 0 0 0 0 0 5 5 5 5 5 5 5 5 0 0 0 0 0 0 3 3 3 3
3 3 3 3 3 0 0 0 0 0 0 0 0 0 0 0 0 0 0 5 5 5 5 5 5 5 5 5 5 5 5 5 5 0 0 0 0 0 5 0 0 0 0 0 0 3 3 3 3 3
3 3 3 3 3 0 0 0 3 0 0 0 5 5 5 5 5 5 5 5 0 0 0 0 0 0 0 0 14 13 0 0 0 0 0 0 0 0 5 0 0 0 0 0 3 3 3 3 3 3
3 3 3 3 3 3 0 0 0 3 0 5 5 0 0 0 0 0 0 0 0 0 0 0 0 0 0 0 0 5 0 0 0 0 0 0 0 0 5 5 0 0 0 0 0 3 3 3 3 3
3 3 3 3 3 3 0 3 0 0 3 5 0 0 0 0 0 0 0 0 0 0 0 0 0 0 3 3 3 5 3 3 3 3 3 0 0 0 0 5 0 0 0 0 0 3 3 3 3 3
3 3 3 3 3 3 0 0 3 0 0 5 0 0 0 0 0 0 0 0 0 0 3 3 3 3 3 3 3 5 5 3 3 3 3 3 0 0 0 5 0 0 0 0 0 3 3 3 3 3
3 3 3 3 3 3 0 0 0 0 0 5 0 0 0 0 0 0 0 3 3 3 3 3 3 3 3 3 3 3 5 3 3 3 3 3 0 0 0 5 5 0 0 0 0 3 3 3 3 3
3 3 3 3 3 3 0 0 0 3 0 5 5 0 0 0 0 0 0 3 3 3 3 3 3 3 3 3 3 5 5 5 3 3 3 3 3 0 0 0 5 0 0 3 0 3 3 3 3 3
3 3 3 3 3 3 3 0 0 0 0 0 5 5 0 0 0 0 0 0 3 3 3 3 3 3 3 3 3 5 5 5 3 3 3 3 3 0 0 0 5 0 0 0 3 3 3 3 3 3
3 3 3 3 3 3 3 3 0 0 0 0 0 5 0 0 0 0 0 0 0 3 3 3 3 3 3 3 3 5 5 5 3 3 3 3 3 3 0 0 5 0 0 0 0 3 3 3 3 3
3 3 3 3 3 3 3 3 0 0 0 3 0 5 5 0 0 0 0 0 0 0 0 3 3 3 3 3 3 3 3 3 3 3 3 3 3 3 0 0 5 0 0 0 0 0 3 3 3 3
3 3 3 3 3 3 3 3 0 0 0 0 0 0 5 5 5 5 5 0 0 0 0 0 0 0 3 3 3 3 3 3 3 3 3 3 0 0 0 5 5 0 0 0 0 0 3 3 3 3
3 3 3 3 3 3 3 0 0 0 0 0 0 0 0 0 0 3 5 5 5 5 5 0 0 0 0 0 0 3 3 3 3 3 3 0 0 0 5 5 0 0 0 0 0 3 3 3 3 3
3 3 3 3 3 3 3 0 0 3 0 0 0 3 0 3 0 0 0 0 0 0 5 5 5 5 5 0 0 0 0 0 0 0 0 0 0 0 5 0 0 0 0 0 3 3 3 3 3 3
3 3 3 3 3 3 3 0 0 0 0 0 0 0 0 0 3 0 0 3 0 0 0 0 0 0 5 5 5 5 0 0 0 0 0 0 0 0 5 0 0 0 0 0 3 3 3 3 3 3
3 3 3 3 3 3 3 0 2 2 2 2 2 2 2 2 0 0 0 0 0 3 0 0 0 0 3 0 0 5 5 5 5 0 0 0 0 5 5 0 0 0 0 0 3 3 3 3 3 3
3 3 3 3 3 3 3 0 2 6 6 6 6 6 6 2 0 0 0 0 0 0 0 0 0 3 0 0 0 0 0 0 5 5 5 5 5 5 5 5 0 0 0 0 0 3 3 3 3 3
3 3 3 3 3 3 0 0 2 6 6 6 6 6 6 6 5 5 5 5 5 5 5 5 5 5 5 5 5 5 5 5 5 0 0 0 0 0 0 5 5 5 0 0 0 3 3 3 3 3
3 3 3 0 0 0 0 0 2 6 6 6 6 6 6 2 0 0 0 0 0 0 0 0 0 0 0 0 0 0 0 0 0 0 3 0 0 0 0 0 0 5 5 0 0 3 3 3 3 3
3 3 0 0 2 2 2 2 2 6 6 6 2 2 2 2 0 0 0 0 0 0 0 0 0 3 0 0 3 0 0 0 0 0 0 0 0 3 0 3 0 0 5 0 0 0 3 3 3 3
3 3 0 0 2 6 6 6 6 6 6 6 2 0 0 0 0 3 0 0 3 0 0 0 3 0 0 0 0 0 0 3 0 3 0 0 3 0 0 0 0 0 5 5 0 0 3 3 3 3
3 3 0 0 2 6 6 6 6 6 6 6 2 0 3 0 0 0 0 0 0 3 0 0 0 3 0 0 3 0 0 0 0 0 0 3 3 3 0 0 0 0 0 5 0 0 3 3 3 3
3 3 0 0 2 6 6 6 6 6 6 6 2 0 0 3 3 0 0 0 0 3 3 0 0 0 0 3 0 0 3 0 0 0 3 0 3 0 0 0 0 2 2 6 2 2 0 3 3 3
3 3 0 0 2 2 2 2 2 2 2 2 2 0 0 0 3 3 0 0 3 0 0 0 0 0 3 3 0 0 0 0 0 0 0 0 0 0 0 3 0 2 6 6 6 2 0 0 3 3
3 3 3 0 0 0 0 0 0 0 0 0 0 0 0 0 0 0 0 0 0 0 0 3 0 0 3 0 0 0 0 0 0 0 0 0 0 0 0 0 0 2 6 6 6 2 0 0 3 3
3 3 3 3 3 3 3 3 3 0 0 0 1 1 1 1 1 1 1 1 0 0 0 0 0 0 0 0 0 0 0 0 3 3 3 3 3 3 0 0 0 2 6 6 6 2 0 0 3 3
3 3 3 0 0 0 0 0 0 0 0 1 1 1 1 1 1 1 1 1 1 1 1 0 0 0 0 3 0 0 0 3 3 3 3 3 3 3 0 0 0 2 6 6 6 2 0 0 3 3
3 3 0 0 0 0 0 1 1 1 1 1 1 1 1 1 1 1 1 1 1 0 0 0 0 0 0 0 0 0 0 3 3 3 3 3 3 3 3 0 0 2 2 2 2 2 0 3 3 3
3 3 0 0 0 0 1 1 1 1 1 1 1 1 1 1 1 1 1 0 0 0 0 0 0 0 0 0 0 0 3 3 3 3 3 3 3 3 3 0 0 0 0 0 0 0 0 3 3 3
3 3 3 3 0 0 0 0 0 0 1 1 1 1 1 1 0 0 0 0 0 0 0 0 0 3 3 3 3 3 3 3 3 3 3 3 3 3 3 3 0 0 0 0 0 0 3 3 3 3
3 3 3 3 3 3 3 3 3 0 0 0 0 0 0 0 0 0 0 0 0 3 3 3 3 3 3 3 3 3 3 3 3 3 3 3 3 3 3 3 3 3 3 3 3 3 3 3 3 3
3 3 3 3 3 3 3 3 3 3 3 3 3 3 3 3 3 3 3 3 3 3 3 3 3 3 3 3 3 3 3 3 3 3 3 3 3 3 3 3 3 3 3 3 3 3 3 3 3 3
3 3 3 3 3 3 3 3 3 3 3 3 3 3 3 3 3 3 3 3 3 3 3 3 3 3 3 3 3 3 3 3 3 3 3 3 3 3 3 3 3 3 3 3 3 3 3 3 3 3